BBBBBBBBBBBBBBBBBBBBBBBB
BBBBBBBBBBBBBBBBBBBBBBBB
B0000000000000000000000B
B0000000000000000000000B
B0000000000000000000000B
B0000000000000000000000B
B0000000000000000000B00B
B00000000BB000000B00000B
B000000BB00000B00000000B
BD000BB000000BBB0000000B
BBBBBBBBBBBBBBBBBBBBBBBB
BBBBBBBBBBBBBBBBBBBBBBBB