BBBBBBBBBBBBBBBBBBBBBBBB
BBBBBBBBBBBBBBBBBBBBBBBB
B0000000000000000000000B
B0000000000000000000000B
B0000000000000000000000B
B0000000000000000000000B
B0000000000000000000000B
B00000000BB000000000000B
B000000BB00000000000000B
B0000BB000000000D000000B
BBBBBBBBBBBBBBBBBBBBBBBB
BBBBBBBBBBBBBBBBBBBBBBBB