BBBBBBBBBBBBBBBBBBBBBBBB
BBBBBBBBBBBBBBBBBBBBBBBB
B0000000000000000000000B
B0000000000000000000000B
B0000000000000000000000B
B0000000000000000000000B
B0000000000000000000000B
B000000D0BB000000000000B
B000000BB00000000000000B
B0000BB000BBBBBBBBBBB00B
BBBBBBBBBBBBBBBBBBBBBBBB
BBBBBBBBBBBBBBBBBBBBBBBB